9#1184#256#
6#1152#384#
6#1120#384#
6#1088#384#
6#1056#384#
6#1024#384#
6#992#384#
5#928#384#
5#896#384#
5#864#384#
5#832#384#
5#800#384#
0#672#416#
0#640#416#
0#576#416#
0#608#416#
0#512#416#
0#544#416#
0#480#416#
0#448#416#
0#416#416#
0#384#416#
0#352#416#
0#288#416#
0#320#416#
0#256#416#
0#192#416#
0#224#416#
0#160#416#
0#128#416#
0#96#416#
0#64#416#
0#32#416#
0#0#416#
2#736#384#
